=######===
##  X ####
#   T    #
#  XCO  B#
#        #
#    P   #
#    B   #
#        #
# TC    E#
##########
